20 15 0 1
0  0  0  0  0  0  0  0  0  0  0  0  0  0  0  0  0  0  0  0
0  0  0  0  0  0  0  0  0  0  0  0  0  0  0  0  0  0  0  0
0  0  0  0  0  0  0  0  0  0  0  0  0  0  0  0  0  0  0  0
0  0  0  0  0  0  0  0  0  0  0  0  0  0  0  0  0  0  0  0
0  0  0  0  0  0  0  0  0  0  0  0  0  0  0  0  0  0  0  0
0  0  0  0  0  0  0  0  0  0  0  0  0  0  0  0  0  0  0  0
0  0  0  0  0  0  0  0  0  0  0  0  0  0  0  0  0  0  0  0
0  0  0  0  0  0  0  0  0  0  0  0  0  0  0  0  0  0  0  0
0  0  0  0  0  0  0  0  0  0  0  0  0  0  0  12 0  0  14 0
0  0  0  0  0  0  0  0  0  0  0  0  0  0  24 26 0  24 25 26
0  0  0  0  0  0  0  6  0  0  2  0  0  0  35 37 0  35 36 37
0  0  0  0  0  0  38 44 13 43 44 13 43 28 47 47 63 47 47 48
0  9  0  0  0  0  45 0  0  0  0  0  0  45 0  0  0  0  0  0
0  2  0  2  0  2  45 0  0  0  0  0  0  45 0  14 0  15 0  0
24 25 25 25 25 28 36 27 25 25 25 25 28 36 27 25 25 25 25 26


