20 15 0 1 
0 0 0 0 0 0 0 0 0 0 0 0 0 0 0 0 0 0 0 0 
0 0 0 0 0 0 0 0 0 0 0 0 0 0 0 0 0 0 14 0 
0 0 0 0 0 0 0 0 0 0 0 0 0 0 0 0 0 0 0 0 
0 0 0 0 0 0 0 0 0 10 0 0 5 0 0 0 0 0 0 0 
0 0 0 0 0 0 0 0 0 0 0 0 0 0 0 0 0 0 0 0 
0 0 0 0 0 0 0 0 0 0 0 0 0 0 0 0 0 15 0 0 
0 0 0 0 0 0 0 0 0 0 0 0 0 0 0 0 0 0 0 0 
0 0 0 0 0 0 0 0 0 0 0 0 0 0 0 0 0 0 0 0 
0 0 0 0 0 0 0 0 0 0 0 0 0 6 0 0 0 0 14 0 
0 0 0 0 0 0 0 0 0 0 0 0 0 0 0 0 0 0 0 0 
0 0 0 0 0 0 0 0 0 0 0 0 0 0 0 0 0 0 0 0 
0 0 0 0 0 0 0 0 0 0 0 0 0 0 0 0 0 0 0 0 
0 0 0 11 0 0 0 0 0 0 0 0 0 0 0 0 0 0 0 0 
0 0 0 0 0 0 0 0 0 0 0 0 0 0 0 0 0 0 0 0 
0 0 0 0 0 0 0 0 0 0 0 0 0 0 0 0 0 0 0 0 

0 0 0 0 0 0 0 0 0 0 0 0 0 0 0 0 0 0 0 0 
0 0 0 0 0 0 0 0 0 0 0 0 0 0 0 0 0 0 0 0 
0 0 0 0 0 0 0 0 0 0 0 0 0 0 0 24 25 25 25 26 
0 2 9 12 0 0 0 0 0 0 0 2 0 0 53 47 47 47 47 48 
21 22 22 44 13 13 0 0 0 21 22 22 22 30 48 0 0 0 0 0 
0 0 0 0 0 0 0 0 0 0 0 0 0 0 0 0 0 0 0 0 
0 0 0 0 0 0 0 0 0 0 0 0 0 0 0 0 24 25 25 26 
0 0 0 0 0 0 0 0 0 0 0 0 0 0 0 0 40 47 47 41 
0 0 0 0 0 0 0 0 0 0 0 0 0 0 0 53 48 0 0 45 
0 2 0 0 0 0 0 0 2 0 0 0 38 22 30 48 0 0 24 41 
24 26 0 0 0 0 0 24 26 0 0 53 48 0 0 0 0 13 46 48 
40 37 0 0 0 0 0 46 41 13 32 48 0 0 0 0 0 0 0 0 
40 37 0 0 0 2 0 0 45 0 0 0 0 2 0 12 0 2 2 0 
40 36 27 25 25 25 26 0 35 27 25 25 25 25 25 25 25 25 25 26 
35 36 36 36 36 36 36 57 36 36 36 36 36 36 36 36 36 36 36 41 