20 15 0 1 
0 0 0 0 0 0 0 0 0 0 0 0 0 0 0 0 0 0 0 0 
0 0 0 0 0 0 0 0 0 0 0 0 0 0 0 0 0 0 0 0 
0 0 0 0 0 0 0 0 0 0 0 0 0 0 0 0 0 0 15 0 
0 0 0 0 0 0 0 0 0 0 0 0 0 0 0 0 0 0 0 0 
0 6 0 0 0 0 0 0 0 0 0 0 0 0 5 0 0 0 14 0 
0 0 0 0 0 0 0 0 0 0 0 0 0 0 0 0 0 0 0 0 
0 0 0 0 0 0 0 0 0 0 0 0 0 0 0 0 0 0 0 0 
0 0 0 0 0 0 0 0 0 0 0 0 0 0 0 0 0 0 0 0 
0 0 0 0 0 0 0 0 0 0 0 0 0 0 0 0 0 0 0 0 
0 14 0 0 0 0 0 0 0 0 0 0 0 0 0 0 0 0 0 0 
0 0 0 0 0 0 0 0 0 0 0 0 0 0 0 0 0 0 0 0 
0 0 0 0 0 0 0 0 0 0 0 0 0 0 0 0 0 0 0 0 
0 0 0 0 0 0 0 0 0 0 0 0 0 0 0 0 0 0 0 0 
0 0 0 0 0 0 0 10 0 0 0 0 0 0 0 0 0 0 0 0 
0 0 0 0 0 0 0 0 0 0 0 0 0 0 0 0 0 0 0 0 
0 0 0 0 0 0 0 0 0 0 0 0 0 0 0 0 0 0 0 0 
0 0 0 0 0 0 0 0 0 0 0 0 0 0 0 0 0 0 0 0 
0 0 0 0 0 0 0 0 0 0 0 0 0 0 0 0 0 0 0 0 
0 0 0 0 0 0 0 0 0 0 0 0 0 0 0 0 0 21 22 23 
0 0 9 0 2 0 0 0 0 0 0 0 0 0 0 0 12 0 0 0 
21 22 44 13 13 43 23 0 0 0 0 0 13 43 22 22 22 22 22 23 
0 0 0 0 0 0 0 0 0 0 0 0 0 0 0 0 0 0 0 0 
0 0 0 0 0 0 34 2 2 0 0 0 0 0 0 0 0 0 0 0 
0 0 0 0 0 0 46 29 44 13 43 22 26 0 0 0 0 0 0 0 
0 0 0 0 0 0 0 0 0 0 0 0 46 54 0 0 0 0 0 0 
24 25 25 26 0 0 0 0 0 0 0 0 0 46 54 0 0 0 0 0 
46 47 47 48 0 0 0 0 0 0 0 0 0 0 46 56 0 0 0 0 
0 0 0 0 0 0 0 0 0 0 0 0 34 0 0 0 0 0 2 0 
0 2 0 0 0 0 2 0 0 0 0 2 45 2 0 0 0 2 2 0 
24 25 25 25 25 25 25 25 25 25 25 28 36 27 25 25 25 25 25 26 