20 15 1 0 
0 0 0 0 0 0 0 0 0 0 0 0 0 0 0 0 0 0 0 0 
0 0 0 0 0 0 0 0 0 0 0 0 0 0 0 0 0 0 0 0 
0 0 0 0 0 0 0 0 0 0 0 0 0 0 0 0 0 0 15 0 
0 0 0 0 0 0 0 0 0 0 0 0 0 0 0 0 0 0 0 0 
0 0 0 0 0 0 0 0 0 0 0 0 0 0 0 0 0 0 0 0 
0 0 0 0 0 0 0 0 0 0 0 0 0 0 0 0 14 0 0 0 
0 0 0 0 0 0 0 0 0 0 0 0 0 0 0 0 0 0 0 0 
0 0 0 0 0 0 16 0 0 0 0 0 0 0 0 0 0 0 0 0 
0 0 0 0 0 0 0 0 0 0 0 0 0 0 0 0 0 0 0 0 
0 0 0 0 0 0 0 0 0 0 0 0 0 0 0 0 0 0 0 0 
0 0 0 0 0 0 0 0 0 0 0 0 0 0 0 0 0 0 0 0 
0 0 0 0 0 0 0 0 0 0 0 0 0 0 0 0 0 0 0 0 
0 0 0 0 0 0 0 0 0 0 0 0 0 0 0 0 0 0 0 0 
0 0 0 0 0 0 0 0 0 0 0 0 0 0 0 0 0 14 6 0 
0 0 0 0 0 0 0 0 0 0 0 0 0 0 0 0 0 0 0 0 
0 0 0 0 0 0 0 0 0 0 0 0 0 0 0 0 0 0 0 0 
0 0 0 0 0 0 0 0 0 0 0 0 0 0 0 0 0 0 0 0 
0 0 0 0 0 0 0 12 0 9 0 0 0 0 0 21 26 0 0 0 
0 0 0 0 0 21 22 22 22 23 0 0 0 2 0 0 46 29 22 23 
0 0 0 0 0 0 0 0 0 0 0 0 0 2 2 0 0 0 0 0 
0 2 2 0 0 0 0 0 0 0 0 0 21 22 22 26 0 0 0 0 
21 22 22 22 23 0 0 0 0 0 0 0 0 0 0 46 29 23 0 0 
0 0 0 0 0 0 0 0 0 0 0 0 0 0 0 0 0 0 0 0 
0 2 0 0 0 21 22 23 0 0 0 0 0 0 0 0 0 0 0 0 
0 2 2 0 0 0 0 0 0 0 24 26 0 0 0 0 0 0 0 0 
0 2 2 2 0 0 0 0 0 0 35 37 0 0 0 0 0 0 0 0 
21 22 22 22 23 0 0 0 0 0 35 37 0 0 0 34 0 0 0 0 
0 0 0 0 0 0 0 0 0 0 35 37 0 0 0 45 0 0 0 0 
0 2 2 2 0 0 0 0 0 0 35 37 2 2 0 45 0 0 0 0 
24 25 25 25 25 25 25 25 25 28 36 36 27 25 28 36 27 25 25 26 