20 15 1 0 
0 0 0 0 0 0 0 0 0 0 0 0 0 0 0 0 0 0 0 0 
0 0 0 0 0 0 0 0 0 0 0 0 0 0 0 0 0 0 0 0 
0 0 0 0 0 0 0 0 0 0 0 0 0 0 0 0 0 0 0 0 
0 0 0 0 0 0 0 0 0 0 0 0 0 0 0 0 0 0 0 0 
0 0 0 0 0 0 15 0 0 0 0 0 0 0 0 0 0 0 0 0 
0 0 0 0 0 0 0 0 0 0 0 0 0 0 0 0 0 0 0 0 
0 0 0 0 0 0 0 0 0 0 0 0 0 0 0 0 0 0 0 0 
0 0 0 0 0 0 0 0 0 0 0 0 0 0 0 0 0 0 0 0 
0 0 0 0 0 0 0 0 0 0 0 0 11 0 16 0 70 0 0 0 
0 0 0 0 0 0 0 0 0 0 0 0 0 0 0 0 0 0 0 0 
0 0 0 0 0 0 0 0 6 0 0 0 0 0 0 0 0 0 0 0 
0 0 0 0 0 0 0 0 0 0 0 0 0 0 0 0 0 0 0 0 
0 0 0 0 0 0 0 0 0 0 0 0 0 0 0 0 0 0 0 0 
0 0 0 0 0 0 0 0 0 0 0 0 0 0 0 0 0 0 0 0 
0 0 0 0 0 0 0 0 0 0 0 0 0 0 0 0 0 0 0 0 
0 0 0 0 0 0 0 0 0 0 0 0 0 0 0 0 0 0 0 0 
0 0 0 0 0 0 0 0 0 0 0 0 0 0 0 0 0 0 0 0 
0 0 0 0 0 0 0 0 0 0 0 0 0 0 0 0 0 0 0 0 
0 0 0 0 0 34 0 0 0 0 0 0 0 0 0 0 0 0 0 0 
0 0 0 0 9 45 0 0 0 0 0 0 0 0 0 0 0 0 0 0 
0 0 0 21 30 47 29 22 23 0 0 0 0 0 0 0 0 0 2 2 
0 0 0 0 0 0 0 0 0 0 0 0 0 0 0 0 0 21 22 23 
0 2 0 0 0 0 0 0 0 0 0 0 0 0 0 0 0 0 0 0 
21 22 23 0 0 0 0 0 0 0 0 0 0 0 0 0 0 2 0 0 
0 0 0 0 0 0 0 0 0 0 24 22 22 22 25 25 25 25 25 26 
0 0 0 0 0 0 0 0 0 55 48 0 0 0 35 36 36 36 36 37 
0 0 0 0 2 0 0 21 23 0 0 0 0 24 36 36 36 36 36 37 
0 0 0 2 34 0 0 0 0 0 0 0 2 35 36 36 36 36 36 37 
0 2 0 2 45 2 0 0 0 2 24 25 28 36 36 36 36 36 36 37 
24 25 25 28 36 27 25 25 25 28 36 36 36 36 36 36 36 36 36 37 