20 15 0 1 
0 0 0 0 0 0 0 0 0 0 0 0 0 0 0 0 0 0 0 0 
0 0 0 0 0 0 0 0 0 0 0 0 0 0 0 0 0 0 0 0 
0 0 0 0 0 0 0 0 0 0 0 0 0 0 0 0 0 0 0 0 
0 0 0 0 0 0 0 0 0 0 0 0 0 0 0 0 0 0 16 0 
0 0 0 0 0 0 0 0 0 0 0 0 0 0 0 0 0 0 0 0 
0 0 0 0 0 0 0 0 0 0 0 0 0 0 0 0 0 0 0 0 
0 0 0 0 0 0 0 0 0 0 0 0 0 0 0 0 0 0 0 0 
0 0 0 0 0 0 0 0 0 0 0 0 0 0 0 0 0 0 15 0 
0 0 0 0 0 0 0 0 0 0 0 0 0 0 0 0 0 0 0 0 
0 0 0 0 0 0 0 0 0 0 0 0 0 0 0 0 0 0 0 0 
0 0 0 0 0 0 0 0 0 0 0 0 0 0 0 0 0 0 0 0 
0 0 0 0 0 0 0 0 0 0 0 0 0 0 0 0 0 0 0 0 
0 0 0 0 0 0 0 0 0 0 0 0 0 0 0 0 0 0 0 0 
0 0 0 0 0 0 0 0 0 0 0 0 0 0 0 0 0 0 0 0 
0 0 0 0 0 0 0 0 0 0 0 0 0 0 0 0 0 0 0 0 
0 0 0 0 0 0 0 0 0 0 0 0 0 0 0 0 0 0 0 0 
0 0 0 0 0 0 0 0 0 0 0 0 0 0 0 0 0 0 0 0 
0 0 0 0 0 0 0 0 0 0 0 0 0 0 0 0 0 0 0 0 
0 0 0 0 0 0 0 0 0 0 0 0 0 0 12 0 0 0 0 0 
0 0 0 0 0 0 0 0 0 0 0 0 0 24 26 0 0 21 22 23 
0 0 0 0 0 0 0 0 0 0 2 2 0 35 48 0 0 0 0 0 
0 0 0 0 0 0 0 0 0 24 25 25 28 48 0 0 0 0 0 0 
0 0 0 0 0 0 0 2 2 35 47 47 48 0 0 0 0 0 0 0 
0 0 0 0 0 0 24 25 28 48 0 0 0 0 0 0 0 0 24 26 
0 0 0 0 2 2 35 47 48 0 0 0 0 0 0 0 0 0 35 37 
0 9 0 24 25 28 48 0 0 0 0 0 0 0 0 0 0 0 35 37 
0 2 2 35 47 48 0 2 2 0 0 0 0 0 0 0 0 0 35 37 
21 22 30 48 0 0 0 2 2 2 2 0 0 0 0 0 0 0 35 37 
0 0 0 0 0 0 0 2 2 2 2 0 0 0 0 0 0 0 35 37 
24 25 25 25 25 25 25 25 25 25 25 25 25 25 25 25 25 28 36 37 