20 15 0 1 
0 0 0 0 0 0 0 0 0 0 0 0 0 0 0 0 0 0 0 0 
14 0 0 0 0 0 0 0 4 0 0 0 0 0 0 0 0 15 0 0 
0 0 0 0 0 0 0 0 0 0 0 0 0 0 0 0 0 0 0 0 
0 0 0 0 0 0 0 0 0 0 0 0 0 0 0 0 0 0 0 0 
0 0 0 0 0 0 0 0 0 0 0 0 0 0 0 0 0 0 0 0 
0 0 0 0 0 0 0 0 0 0 0 0 0 0 0 0 0 0 0 0 
0 0 0 0 0 0 0 0 0 0 0 0 0 0 0 0 0 0 0 0 
14 0 0 0 0 0 0 0 0 0 0 0 0 0 0 0 0 0 0 0 
0 0 0 0 0 0 0 0 0 0 0 0 0 6 0 0 0 0 0 0 
0 0 0 0 0 0 0 0 0 0 0 0 0 0 0 0 0 0 0 0 
0 0 0 0 0 0 0 0 0 0 0 0 0 0 0 0 0 0 0 0 
0 0 0 0 0 0 0 0 0 0 0 0 0 0 0 0 0 0 0 0 
0 0 0 0 0 0 0 0 0 0 0 0 0 0 0 0 0 0 0 0 
0 0 0 5 0 0 0 0 0 0 10 0 0 0 8 0 0 0 0 0 
0 0 0 0 0 0 0 0 0 0 0 0 0 0 0 0 0 0 0 0 
0 0 0 0 0 0 0 0 0 0 0 0 0 0 0 0 0 0 0 0 
0 0 0 0 0 0 0 0 0 0 0 0 0 2 0 0 0 0 0 0 
21 23 0 21 23 0 21 22 22 22 23 0 21 23 0 21 22 22 22 23 
0 0 0 0 0 0 0 0 0 0 0 0 0 0 0 0 0 0 0 0 
9 0 2 2 0 2 2 0 2 2 2 2 2 2 2 0 0 0 0 0 
21 22 22 22 22 22 22 22 22 22 22 22 22 22 22 22 23 0 24 26 
0 0 0 0 0 0 0 0 0 0 0 0 0 0 0 0 0 0 35 37 
0 0 0 0 0 0 0 0 0 0 0 0 0 0 0 0 0 0 35 37 
24 26 0 0 0 0 0 0 0 12 0 0 2 0 0 2 0 0 35 37 
35 37 13 43 26 0 0 24 22 22 44 13 43 44 13 43 26 0 35 37 
35 37 0 0 46 54 0 45 0 0 0 0 0 0 0 0 45 0 35 37 
35 37 0 0 0 62 0 45 0 0 0 0 0 0 0 0 45 0 35 37 
35 37 0 0 0 0 0 45 0 0 0 0 0 0 0 0 45 0 35 37 
35 37 0 0 0 0 0 45 0 0 0 0 0 0 0 0 45 0 35 37 
35 36 27 25 25 25 28 36 27 25 25 25 25 25 25 28 36 57 36 37 