20 15 0 1 
0 0 0 0 0 0 0 0 0 0 0 0 0 0 0 0 0 0 0 0 
0 0 0 0 0 0 0 0 0 0 0 0 0 0 15 0 0 0 0 0 
0 0 0 0 0 0 0 0 0 0 0 0 0 0 0 0 0 0 0 0 
0 0 5 0 0 0 0 0 0 0 0 0 0 0 0 0 0 0 0 0 
0 0 0 0 0 0 0 0 0 0 0 0 0 0 4 0 0 0 0 0 
0 0 0 0 0 0 0 0 0 0 0 0 0 0 0 0 0 0 0 0 
0 0 0 0 0 0 0 0 0 0 0 0 0 0 0 0 0 0 0 0 
0 0 0 0 0 0 0 0 0 0 0 0 0 0 0 0 0 0 0 0 
0 0 0 0 0 0 0 0 0 0 0 0 0 0 0 0 0 0 0 0 
0 0 0 0 0 0 0 0 0 0 0 0 0 0 0 0 0 0 0 0 
0 0 0 0 0 0 0 0 0 0 0 0 0 0 0 0 0 0 0 0 
0 0 0 0 0 0 0 0 0 0 0 0 0 0 0 0 0 0 0 0 
0 0 0 0 0 0 0 0 0 0 0 0 0 0 0 0 0 0 0 0 
0 0 0 0 11 0 0 0 0 0 0 0 0 0 0 0 0 0 0 0 
0 0 0 0 0 0 0 0 0 0 0 0 0 0 0 0 0 0 0 0 
0 0 0 0 0 0 0 0 0 0 0 0 0 0 0 0 0 0 0 0 
0 0 0 0 0 0 0 0 9 0 0 0 0 0 0 0 0 0 0 0 
0 0 0 0 24 25 25 25 25 26 0 0 0 21 22 22 23 0 0 0 
0 0 0 0 35 36 36 36 36 37 0 0 0 0 0 0 0 0 0 2 
0 21 22 30 47 47 47 47 47 48 0 0 0 0 0 0 0 0 0 2 
0 0 0 0 0 0 0 0 0 0 0 0 24 25 25 25 25 25 25 26 
2 0 2 0 0 0 0 0 0 0 0 0 35 36 36 36 36 36 36 37 
21 22 23 0 0 0 0 0 0 0 0 0 35 36 36 36 36 36 36 37 
0 0 0 0 0 0 0 0 0 0 2 2 35 36 36 36 36 36 36 37 
0 0 0 0 0 0 0 0 2 2 2 2 35 36 36 36 36 36 36 37 
2 0 0 0 0 0 0 24 25 25 25 28 36 36 36 36 36 36 36 37 
2 2 0 0 0 0 0 35 36 36 36 36 36 36 36 36 36 36 36 37 
2 2 2 0 0 0 0 35 36 36 36 36 36 36 36 36 36 36 36 37 
2 2 2 0 0 0 0 35 36 36 36 36 36 36 36 36 36 36 36 37 
24 25 25 25 25 25 28 36 36 36 36 36 36 36 36 36 36 36 36 37 