20 15 0 1 
0 0 0 0 0 0 0 0 0 0 0 0 0 0 0 0 0 0 0 0 
0 14 0 0 0 0 0 0 0 0 0 0 0 0 0 0 0 0 14 0 
0 0 0 0 0 0 0 0 0 0 0 0 0 0 0 0 0 0 0 0 
0 0 0 0 0 0 0 0 0 0 0 0 0 0 0 0 0 0 0 0 
0 0 0 0 0 0 0 0 0 15 0 0 0 0 0 0 0 4 6 0 
0 0 0 0 0 0 0 0 0 0 0 0 0 0 0 0 0 0 0 0 
0 0 0 0 0 0 0 0 0 0 0 0 0 0 0 0 0 0 0 0 
0 0 0 0 0 0 0 0 0 0 0 0 0 0 0 0 0 0 0 0 
0 0 0 0 0 0 0 0 0 0 0 0 0 0 0 0 0 0 0 0 
0 0 0 0 0 0 0 0 0 0 0 0 0 0 0 0 0 0 0 0 
0 0 0 0 0 0 0 0 0 11 0 0 0 0 0 0 0 0 0 0 
0 0 0 0 0 0 0 0 0 0 0 0 0 0 0 0 0 0 0 0 
0 0 0 0 0 0 0 0 0 0 0 0 0 0 0 0 0 0 0 0 
0 0 0 0 0 0 0 0 0 0 0 0 0 0 0 0 0 0 0 0 
0 0 0 0 0 0 0 0 0 0 0 0 0 0 0 0 0 0 0 0 

0 0 0 0 0 0 0 0 0 0 0 0 0 0 0 0 0 0 0 0 
0 0 0 0 0 0 0 0 0 9 2 0 0 0 12 0 0 0 0 0 
21 22 44 13 43 22 22 44 13 43 44 13 43 22 22 44 13 43 22 23 
0 0 0 0 0 0 0 0 0 0 0 0 0 0 0 0 0 0 0 0 
0 0 0 0 0 0 0 0 0 0 0 0 0 0 0 0 0 0 0 0 
0 0 0 0 0 0 0 0 0 24 23 0 0 0 0 0 21 25 25 26 
0 0 0 0 0 0 0 0 0 45 0 0 0 0 0 0 0 46 47 48 
0 0 0 0 0 0 0 0 0 45 0 0 0 0 0 0 0 0 0 0 
0 0 0 0 0 0 0 0 55 47 29 23 0 0 0 0 0 0 0 0 
0 0 0 0 0 0 60 0 0 0 0 0 0 60 0 0 0 0 0 0 
0 0 0 0 0 60 0 0 0 0 0 0 0 0 60 0 0 0 0 0 
0 0 0 0 60 0 0 0 0 24 26 0 0 0 0 60 0 0 0 2 
0 2 0 0 0 0 0 0 2 35 37 2 0 0 0 0 0 0 2 2 
0 2 0 2 0 0 2 0 2 35 37 2 0 2 0 2 0 2 2 2 
24 25 25 25 25 25 25 25 28 36 36 27 25 25 25 25 25 25 25 26 