20 15 0 1 
0 0 0 0 0 0 0 0 0 0 0 0 0 0 0 0 0 0 0 0 
0 0 0 0 0 0 0 0 0 0 0 0 0 0 0 0 0 0 14 0 
0 0 0 0 0 0 0 0 0 0 0 0 0 0 0 6 0 0 0 0 
0 0 0 0 0 0 0 0 0 0 0 0 0 0 0 0 0 0 0 0 
0 0 0 0 0 0 0 0 0 0 0 0 0 0 0 0 0 0 0 0 
0 0 0 0 0 0 0 0 70 0 0 0 0 0 0 8 0 0 0 0 
0 5 0 0 0 0 0 0 0 0 0 0 0 0 0 0 0 0 0 0 
0 0 0 0 0 0 0 0 0 0 0 0 0 0 0 0 0 0 0 0 
0 0 0 0 0 0 0 0 0 0 0 0 0 0 0 0 0 0 0 0 
0 14 0 0 0 0 0 0 0 0 0 0 0 0 0 0 0 0 0 0 
0 0 0 0 0 0 0 0 0 0 0 0 0 0 0 0 0 0 0 0 
0 0 0 0 0 0 0 15 0 0 0 0 0 0 0 0 0 0 0 0 
0 0 0 0 0 0 0 0 0 0 0 0 0 0 0 0 0 0 0 0 
0 0 0 0 0 0 0 0 0 0 0 0 0 0 11 0 0 0 0 0 
0 0 0 0 0 0 0 0 0 0 0 0 0 0 0 0 0 0 0 0 
0 0 0 0 0 0 0 0 0 0 0 0 0 0 0 0 0 0 0 0 
0 9 2 0 0 0 12 0 0 2 0 0 0 0 0 0 0 0 0 0 
21 22 44 13 43 22 44 13 43 22 23 0 0 0 0 0 24 22 22 23 
0 0 0 0 0 0 0 0 0 0 0 0 0 0 21 30 48 0 0 0 
0 0 0 0 0 0 0 0 0 0 0 0 0 0 0 0 0 0 0 0 
0 0 0 0 0 0 0 0 0 0 0 0 0 0 0 0 0 0 0 0 
0 0 0 24 25 59 13 58 59 13 58 25 25 59 13 58 25 26 0 0 
21 22 30 47 47 48 0 46 48 0 46 47 47 48 0 46 47 47 29 23 
0 0 0 0 0 0 60 0 0 60 0 0 0 0 60 0 0 0 0 0 
0 0 0 0 0 0 0 0 0 0 0 0 0 0 0 0 0 0 0 0 
21 22 23 0 0 0 0 0 0 24 25 23 0 0 0 0 0 0 0 0 
0 0 0 0 0 0 0 0 0 35 37 0 0 0 0 0 0 0 0 0 
0 0 0 0 0 0 0 21 30 47 48 0 0 0 0 0 2 0 0 0 
0 12 0 12 0 12 0 0 0 0 0 0 0 0 0 0 2 2 0 0 
24 25 25 25 25 25 25 25 25 25 25 25 25 25 25 25 25 25 25 26 