20 15 1 0 
0 0 0 0 0 0 0 0 0 0 0 0 0 0 0 0 0 0 0 0 
0 0 0 0 0 0 0 0 0 0 0 0 0 0 0 0 0 0 0 0 
0 0 14 0 19 0 0 0 0 0 0 0 0 0 11 0 0 15 0 0 
0 0 0 0 0 0 0 0 0 0 0 0 0 0 0 0 0 0 0 0 
0 0 0 0 0 0 0 0 0 0 0 0 0 0 0 0 0 0 0 0 
0 0 0 0 0 0 0 0 0 0 0 0 0 0 0 0 0 0 0 0 
0 0 0 0 0 0 0 0 0 0 0 0 0 0 0 0 0 0 0 0 
0 0 0 0 0 0 0 0 0 0 0 0 0 0 0 0 0 0 0 0 
0 0 0 0 0 0 0 0 0 0 0 0 0 0 0 0 0 0 14 0 
0 0 0 0 0 18 0 0 0 0 0 0 0 0 0 0 0 0 0 0 
0 0 0 0 0 0 0 0 0 0 0 0 0 0 0 0 0 0 0 0 
0 0 0 0 0 0 0 0 0 0 0 0 0 0 0 0 0 0 0 0 
0 0 0 0 0 0 0 0 0 0 0 0 0 0 0 0 0 0 0 0 
0 0 0 6 0 0 0 0 0 0 0 3 0 0 0 0 0 0 0 0 
0 0 0 0 0 0 0 0 0 0 0 0 0 0 0 0 0 0 0 0 
0 0 0 0 0 0 0 0 0 0 0 0 0 0 0 0 0 0 0 0 
0 0 0 0 0 0 0 0 0 0 0 0 0 0 0 0 0 0 0 0 
0 0 0 0 0 0 0 0 0 0 0 0 0 0 0 0 0 0 0 0 
24 25 25 25 25 44 13 13 13 43 22 25 25 25 25 25 25 25 25 26 
35 36 36 36 48 0 0 0 0 0 0 46 36 36 36 36 36 36 36 37 
46 47 47 48 0 0 0 2 2 34 9 2 35 36 36 36 36 36 36 37 
0 0 0 0 0 0 0 21 30 47 29 30 47 47 47 47 47 47 47 48 
2 2 0 0 0 0 0 0 0 0 0 0 0 0 0 0 0 0 0 0 
2 2 2 0 0 0 0 0 0 0 0 0 0 0 0 0 0 0 0 0 
12 2 2 2 0 0 0 0 0 0 0 0 0 0 0 0 0 24 25 26 
21 22 22 22 22 22 23 0 0 0 0 0 0 0 0 0 0 35 36 37 
0 0 0 0 0 0 0 0 0 0 0 0 0 0 0 0 0 35 36 37 
0 2 0 0 0 0 0 0 0 0 0 0 0 0 0 0 0 35 36 37 
0 12 0 0 0 0 0 0 0 0 0 0 0 0 0 0 0 35 36 37 
24 25 25 25 25 25 25 25 25 25 25 25 25 25 25 25 28 36 36 37 