20 15 1 0 
0 0 0 0 0 0 0 0 0 0 0 0 0 0 0 0 0 0 0 0 
0 0 0 0 0 4 0 0 0 70 0 0 0 0 0 0 0 0 0 0 
0 0 0 0 0 0 0 0 0 0 0 0 0 0 0 0 0 0 0 0 
0 14 0 0 0 0 0 0 0 0 0 0 0 0 0 0 0 0 0 0 
0 0 0 0 0 0 0 0 0 0 15 0 0 0 0 0 0 0 0 0 
0 0 0 0 0 0 0 0 0 0 0 0 0 0 0 0 0 0 0 0 
0 11 0 0 0 0 0 19 0 0 0 0 0 0 0 0 0 0 0 0 
0 0 0 0 0 0 0 0 0 0 0 0 0 0 0 0 0 0 0 0 
0 0 0 0 0 0 0 0 0 0 0 0 0 0 0 0 0 0 0 0 
0 0 0 0 0 0 0 0 0 0 0 0 0 0 0 0 0 0 0 0 
0 14 0 0 0 0 0 0 0 0 0 0 0 0 0 0 0 0 0 0 
0 0 0 0 0 0 0 0 0 0 0 0 0 0 0 0 0 0 0 0 
0 0 0 0 0 0 0 0 0 0 0 0 0 0 0 0 0 0 0 0 
0 0 0 0 0 0 0 0 0 0 0 0 0 0 0 0 0 0 5 0 
0 0 0 0 0 0 0 0 0 0 0 0 0 0 0 0 0 0 0 0 
0 
0 0 0 0 0 0 0 34 0 0 0 0 0 0 0 0 0 0 0 0 
0 0 0 0 0 0 0 45 0 0 2 0 0 0 0 0 21 23 0 9 
0 0 0 0 21 22 30 47 29 22 22 44 13 43 26 0 0 0 0 34 
0 0 0 0 0 0 0 0 0 0 0 0 0 0 46 29 22 44 13 62 
21 22 23 0 0 0 0 0 0 0 0 0 0 0 0 0 0 0 0 0 
0 0 0 0 0 0 0 0 0 0 38 23 0 0 0 0 0 0 0 0 
0 0 0 0 12 0 0 0 0 0 45 0 0 0 0 0 0 0 0 0 
21 22 22 22 22 22 22 22 22 30 48 0 0 0 0 0 0 0 0 0 
0 0 0 0 0 0 0 0 0 0 0 0 0 0 0 0 0 0 0 0 
0 0 0 0 0 34 0 0 0 0 0 0 0 0 2 2 2 0 0 0 
0 0 0 0 0 45 0 34 0 0 0 0 0 2 2 2 2 0 0 0 
24 25 26 0 0 45 0 45 0 0 0 0 21 22 22 22 23 0 0 0 
35 36 36 54 0 46 63 47 29 22 23 0 0 0 0 0 0 0 0 0 
35 36 36 37 0 0 0 0 0 0 0 0 0 0 12 0 0 0 0 0 
35 36 36 36 27 25 25 25 25 25 25 25 25 25 25 25 25 25 25 25 