20 15 0 1 
0 0 0 0 0 0 0 0 0 0 0 0 0 0 0 0 0 0 0 0 
0 0 0 14 0 0 70 0 0 0 0 0 0 0 0 0 0 0 0 0 
0 0 0 0 0 0 0 0 0 0 0 0 0 0 0 0 0 0 0 0 
0 0 0 0 0 0 0 0 0 0 0 0 0 0 0 0 0 0 0 0 
0 0 0 0 0 0 0 0 0 0 0 0 0 0 0 0 0 0 0 0 
0 0 0 0 0 0 0 0 0 0 0 0 0 0 0 0 0 0 0 0 
0 0 0 0 0 0 0 0 0 0 0 0 0 0 0 0 0 0 0 0 
0 0 0 0 0 0 0 0 0 0 0 0 0 0 0 0 0 0 0 0 
0 5 6 0 0 3 0 0 0 0 0 0 0 0 0 0 0 0 0 0 
0 0 0 0 0 0 0 0 0 0 0 0 0 4 0 0 0 0 0 0 
0 0 0 0 0 0 0 0 0 0 0 0 0 0 0 0 0 0 0 0 
0 0 0 0 0 0 0 0 0 0 0 0 0 0 0 0 0 0 0 0 
0 0 0 0 0 0 0 0 0 0 0 0 0 0 0 0 0 0 0 0 
0 15 0 0 18 0 14 0 0 11 0 0 0 8 0 0 0 0 0 0 
0 0 0 0 0 0 0 0 0 0 0 0 0 0 0 0 0 0 0 0 
0 0 0 0 0 0 0 0 0 0 0 0 0 0 0 0 0 0 0 0 
0 0 0 0 0 0 0 0 0 0 0 0 0 0 0 0 0 0 0 0 
0 0 21 44 13 43 44 13 43 23 0 0 0 0 0 0 0 0 2 0 
0 0 0 9 0 0 0 0 0 0 0 0 0 0 0 0 0 2 2 0 
21 22 22 22 22 22 22 26 0 0 0 0 0 0 0 0 2 2 2 0 
0 0 0 0 0 0 0 45 0 0 0 0 0 0 0 2 2 2 2 0 
0 0 0 0 0 0 0 46 33 13 61 13 61 0 2 2 2 2 2 0 
0 0 0 0 0 0 0 0 0 0 0 0 0 21 44 13 13 13 43 23 
0 0 0 0 0 0 0 0 0 0 0 0 0 0 0 0 0 0 0 0 
24 22 22 22 22 22 22 26 0 0 0 0 0 0 0 0 0 0 0 0 
45 0 0 0 0 0 0 45 0 0 0 0 21 22 23 0 0 0 0 0 
45 0 0 0 0 0 0 45 0 0 0 0 0 0 0 0 0 0 0 0 
45 0 0 0 0 0 0 45 0 0 0 34 0 0 0 34 0 0 2 0 
45 0 0 0 0 0 0 45 0 0 0 45 0 0 0 45 0 2 2 0 
46 27 25 25 25 25 28 36 27 25 28 36 27 25 28 36 27 25 25 26 