20 15 0 1 
0 0 0 0 0 0 0 0 0 0 0 0 0 0 0 0 0 0 0 0 
0 0 0 0 0 0 0 0 0 0 0 0 0 0 0 0 0 0 0 0 
0 0 0 0 0 0 0 0 0 14 0 0 0 0 0 0 0 15 0 0 
0 0 0 0 0 0 0 0 0 0 0 0 0 0 0 0 0 0 0 0 
0 0 0 0 0 0 0 0 0 0 0 0 0 0 0 0 0 0 0 0 
0 0 0 0 0 10 0 0 0 0 0 0 3 0 0 0 0 0 0 0 
0 0 0 0 0 0 0 0 0 0 0 0 0 0 0 0 0 0 0 0 
0 0 0 0 0 0 0 0 0 0 0 0 0 0 0 0 0 0 0 0 
0 0 0 0 0 0 0 0 0 0 0 0 0 0 0 0 14 0 0 0 
0 0 0 0 0 0 0 0 0 0 0 0 0 0 0 0 0 0 0 0 
0 0 0 0 0 0 0 0 0 0 0 0 0 0 0 0 0 0 0 0 
0 0 0 0 0 0 0 0 0 0 0 0 0 0 0 0 0 0 0 0 
0 0 0 0 0 0 0 0 0 0 0 0 0 0 0 0 0 0 0 0 
0 0 0 0 0 0 0 0 0 0 0 0 0 0 0 0 0 0 0 0 
0 0 0 0 0 0 0 0 0 0 0 0 0 0 0 0 0 0 0 0 
0 0 0 0 0 0 0 0 0 0 0 0 0 0 0 0 0 0 0 0 
0 0 0 0 0 0 0 0 0 0 0 0 0 0 0 0 0 0 0 0 
0 0 0 0 0 0 0 0 0 0 0 0 0 0 0 0 0 0 0 0 
0 0 0 0 0 0 0 0 21 22 22 22 44 13 43 22 22 22 22 23 
0 0 0 0 0 0 0 0 0 0 0 0 0 0 0 0 0 0 0 0 
0 9 0 0 0 0 0 0 0 0 0 0 0 0 0 0 0 0 0 0 
24 25 25 25 22 22 22 22 22 44 13 43 22 22 22 25 25 25 25 26 
35 36 36 37 0 0 0 0 0 0 0 0 0 0 0 46 47 47 36 37 
35 36 36 37 0 0 0 0 0 0 0 0 0 0 0 0 0 0 35 37 
35 36 36 36 54 0 0 0 0 0 0 0 0 0 0 24 25 28 36 37 
35 36 36 36 37 0 0 0 0 0 0 0 0 0 0 35 36 36 36 37 
35 36 36 36 37 2 2 2 0 0 0 0 0 0 0 35 36 36 36 37 
35 36 36 36 37 2 2 2 2 0 0 0 0 0 0 35 36 36 36 37 
35 36 36 36 36 27 25 25 25 25 25 25 25 26 0 35 36 36 36 37 
35 36 36 36 36 36 36 36 36 36 36 36 36 36 57 36 36 36 36 37 