20 15 0 1 
0 0 0 0 0 0 0 0 0 0 0 0 0 0 0 0 0 0 0 0 
0 0 0 0 0 0 0 0 0 0 0 0 0 0 0 0 0 0 0 0 
0 0 0 0 0 0 0 0 0 0 0 0 0 0 0 0 0 0 0 0 
0 0 0 0 0 0 0 0 0 0 0 14 6 0 0 0 0 0 0 0 
0 0 0 0 0 0 0 0 0 0 0 0 0 0 0 0 0 0 15 0 
0 0 0 0 0 0 0 0 0 0 0 0 0 0 0 0 0 0 0 0 
0 0 0 0 0 0 0 0 0 0 0 0 3 0 0 0 0 0 0 0 
0 0 0 0 0 0 0 0 0 0 0 0 0 0 0 0 0 0 0 0 
0 0 0 0 0 0 0 70 0 0 0 0 0 0 0 0 0 0 14 0 
0 0 0 0 0 0 0 0 0 0 0 0 0 0 0 0 0 0 0 0 
0 0 0 0 0 0 0 0 0 0 0 0 0 0 0 0 0 0 0 0 
0 0 0 0 0 0 0 0 0 0 0 0 0 0 0 0 0 0 0 0 
0 0 0 0 0 0 0 0 0 0 0 0 0 0 0 0 0 0 0 0 
0 19 0 0 0 0 0 0 0 0 0 0 0 0 0 0 10 0 0 0 
0 0 0 0 0 0 0 0 0 0 0 0 0 0 0 0 0 0 0 0 
0 0 0 0 0 0 0 0 0 0 0 0 0 0 0 0 0 0 0 0 
0 0 0 0 0 0 0 0 0 0 0 0 0 0 0 0 0 24 25 26 
0 0 0 0 0 0 0 0 0 0 0 0 0 0 0 0 0 35 47 48 
0 0 0 0 0 0 0 0 0 0 0 0 0 0 24 59 13 62 0 0 
0 0 0 0 0 0 0 0 0 0 21 22 22 30 47 36 0 0 0 0 
0 0 0 0 0 0 0 0 0 0 0 0 0 0 0 35 29 22 25 26 
0 9 0 0 0 0 0 0 0 0 0 0 0 0 0 45 0 0 35 37 
24 26 2 0 0 0 0 0 0 0 0 21 22 22 30 48 0 0 46 48 
35 36 54 0 2 0 0 0 0 0 0 0 0 0 0 0 0 0 0 0 
46 47 47 29 22 44 13 43 23 0 0 0 0 0 0 0 0 24 25 26 
0 0 0 0 0 0 0 0 0 0 0 0 0 0 0 0 55 47 47 48 
0 0 0 0 0 0 0 0 0 0 0 0 0 0 0 0 0 0 0 0 
0 0 0 0 0 0 0 0 0 2 0 0 0 0 0 0 0 0 0 0 
0 0 0 12 0 12 0 0 0 2 0 0 0 0 0 0 0 0 0 0 
24 25 25 25 25 25 25 25 25 25 25 25 25 25 25 25 25 25 25 26 