20 15 1 0 
0 0 0 0 0 0 0 0 0 0 0 0 0 0 0 0 0 0 0 0 
0 0 0 0 0 0 0 0 0 0 0 0 0 0 0 0 0 0 0 0 
0 0 0 0 0 0 0 0 0 0 0 0 0 0 0 0 0 0 0 0 
0 0 0 0 0 0 0 0 0 0 0 0 0 0 0 0 0 0 0 0 
0 0 0 0 0 0 0 0 0 0 0 0 0 0 0 0 0 0 4 0 
0 0 0 0 0 0 0 0 0 0 0 0 0 0 0 0 0 0 0 0 
0 10 0 0 0 0 0 0 0 0 0 0 0 0 0 0 0 0 0 0 
0 0 0 0 0 0 0 0 0 0 0 0 0 0 0 0 0 0 0 0 
0 0 0 0 0 0 0 0 0 0 0 0 0 0 0 0 0 0 0 0 
0 15 0 0 0 0 0 0 0 0 0 0 0 0 0 0 0 0 0 0 
0 0 0 0 0 0 0 0 0 0 0 0 0 0 0 0 0 0 0 0 
0 0 0 0 0 0 0 0 0 0 0 0 0 0 0 0 0 0 0 0 
0 0 0 0 0 0 6 0 0 0 0 0 0 0 0 0 0 0 0 0 
0 0 0 0 0 0 0 0 0 0 0 0 0 0 0 0 0 0 0 0 
0 0 0 0 0 0 0 0 0 0 0 0 0 0 0 0 0 0 0 0 
0 0 0 0 0 0 0 0 0 0 0 0 0 0 0 0 0 0 0 0 
0 0 0 0 0 0 0 0 0 2 2 2 0 0 0 0 0 0 9 0 
21 22 44 13 43 22 22 22 22 22 22 22 22 22 22 22 22 22 22 23 
0 0 0 0 0 0 0 0 0 0 0 0 0 0 0 0 0 0 0 0 
0 0 0 0 0 0 0 0 0 0 0 0 0 0 0 0 0 0 0 0 
0 0 0 0 34 0 34 0 0 0 34 0 0 0 0 34 0 21 25 26 
0 0 0 0 45 0 45 0 0 0 45 2 0 0 0 45 0 0 46 48 
21 22 22 30 47 63 47 29 22 30 37 2 0 0 2 45 0 0 0 0 
0 0 0 0 0 0 0 0 0 0 46 29 22 22 30 48 0 0 0 0 
0 0 0 0 0 0 0 0 0 0 0 0 0 0 0 0 0 12 0 0 
24 25 25 26 0 0 0 0 0 0 0 34 0 0 0 0 21 22 22 23 
35 36 36 37 0 0 0 0 0 0 0 45 0 0 0 0 0 0 0 0 
35 36 36 37 0 0 0 2 12 2 0 45 0 0 0 0 0 0 0 0 
35 36 36 36 27 25 25 25 25 25 28 37 2 0 2 2 2 2 0 0 
35 36 36 36 36 36 36 36 36 36 36 36 27 25 25 25 25 25 25 26 